                                                                                                    
                                                                                                    
                                                                                                    
                                                                                                    
          .        .."...""   ...     .......   .        .. .  ".                                   
          "." " ."""."."".... .""    """""""""""."       ..""...."  ..                              
          .^^"" "...." ". ..     .".."."....""""".       ........". .                         .     
          .^.^. ""..   "         ."   """"""""..".       ."""........                       ^"""    
         "...^" "..  .           ."     ......""""      ...".........                   ^^^^".""    
     ^"...^""^. ...  ...                """"".""""."    "".".......                    ^""".".".    
    ."^""^^.""^""..."....     ....    ...""..."""""""    ......"...                  ^^""""."."     
    ^"^"..^."^^^"".. ...""" ..^^^.   "..."""".. "".""     ... ""...                ^^.^.".".        
    ^.^.""  .""""..   .......^..^.. ""........     "      ... .....              ^.."."^"           
    ^...".             ......""^"    """......     .          ..           " .. ".^^..^....         
    ^"". ...            ..".^.^. .."" ""......                             ."""."".^..^^..   .."    
    ^."   ...            """"^"        ".......                            ."...".......^  ...".    
    ^^   ....             "^..^.    .    ..""                              ....  "".....  ..".""    
         "".               ^^".^.....    "                                .....      ..   ......    
       .".                  ""^.....                                     ""...".".        ."..""    
       "                   .^^"    .                                      ^....""..      """"""     
                           "^"     .         .                     ""     ^...""".       """.""     
                          ^^^"    ...      . .                "     "    ^"..."".        """...     
                         .^^^".  .....                        "     "   ^^^.""...       ........    
                          ...    "...                          "           ^^...         ".....     
                                 ..                            "             ^^.                    
                                  "                                                                 
            "                     ""                                          ...        """        
           ".           ^^^^^^           """ ".        ."...""".     ""."""  .^.      .  .^.        
                       ^..""..^          ...  .      ..."...""^^.    ..."""""^..     .....^^""      
                       ....""."^^                      "".."".^.     """  "^^...     .^..^^^""      
     ."..    "        ...."."."""^^            .        ......^.    .""".  .^^..    .^...^.^"""     
    "."""..  ""      ^^."..^^""""..^....      .".       .   ""^.    .""""  .^.     .^^^.... """     
    .."""""" """..""""^^"..^.^^.."."....     .."            "".^.  ...""" ......" "^^."^^.  """     
    ..  """""""...."""^"^.....^.."......     .."    ....     "^^. ...^.""      "  "^.  """"         
          """"""..."...^^^^.".  ...""...   ....   "....       ."."..^^.""         "..    "          
        "  ""^..."...^^....^".  ....."..  "....." "."...         ...^^.""         .".               
        ".".^.^^^^^.^.^...   "  .. ."."......".""^""""   .       ...^...  "        ""    ...        
        .."...^^^^^^^...""     ".. ."."...."."."""^"^^^.".       "".^...            "" ."".         
         .".."^"^^^^^.."""    ...   .. ....".".""""^^^^."       .."^^.".             " ..".         
         ^^^...^."^^^"."..   ....           ""..."^^^^....     "".^.^"".            ""..""  .".     
        """^^""""""^""....  .....         . . ..."""^".."      ""."^"^^^"            ...""^ ""..    
        """"^^...."""".".    .."              "....".".        .".""^"^.^     ..     ....^. ".".    
         """^""...."""."".   .."" ""    "".   "......."..       "^^..^^.^    "^^.......^^""""...    
       ".."^"."....."""""""   ."""....".....  "". .."....          ^.^.^     "^"^^^^^".^........    
       ".""^""""  ..""""""". "."."""".." ....      ."....     .    ^..^       .^"""^^".""""...."    
        "".^.."    .    """   .".... "     .         .".      .     ^^         .   ""..""".....     
                                                                                                    
                                                                                                    
                                                                                                    
                                                                                                    
