                                                                                                    
                                                                                                    
                                                                                                    
                                                                                                    
           .                              "".        "..."""  ""  ..        ...                     
         ..^.        ""                  ..""        ...."""..."""...      "..."  ..                
        .^^^.        .""             """ ""           ..."""..."""....      ""..  "   ".            
       .^.^"         ."...           """""             .  """...."..""      .... ..  "".....""      
     ""...^"       .""".....          """"   ..            "  """"....      ."..... ""^^"....".     
     ...^^.       """""...".       ..  ""     .   ^^^        """"....       ."..  ...^"""...."""    
        .^.        ..""..."..               ..^"^^."^^       """."..        ...  ...^"^^^""...".    
        ..^.        ..."   ....".     ..   .^^""""^.         ".....         ..   ..^.^^^^^....".    
       ....          .."   .."""".       ..^..^^..           "....         ...   ..^.^^^^......     
       ...".   .     .."    ............"^^.^^^^...          ......          .   ""^..^"....        
      """"".  ...    """     "  "..^^^^^^..^^^^^^.."        ^......             ..^..^^."...        
       .."""."....  .."          .^...."".""^^^^^..   """^  ^^^.       .        ...".^^.".."        
        ."."...... """          ""."."......^^^^...   ..""^^^         ."" ". """....^.^...."        
       ..    "...""""           """"."""". .......   ".."""^           ..."""""".....^..""""        
      ..."     ....".          "".   """    ."....  ^...^"".^     ..   ......"".".^.^.^""".         
     .."."      ...".      "...... .."""      .^....^^^^^^"..^   .^^.   ..".....^.^..^^""           
     .""""   ""  .....   ........  .  "       .^....^^^^^^^..."  .^.^."""."^.^^^.^"^^.^^     ...    
       """        ."""   .......               .^...^^^^^^^....  .^..^^^""^.^.".^^"^""".   ...."    
                   ...  "......                 .^."^^^^"."...   "^""""""^.^"^"^^...^..    .."..    
             "         ."".....     .            .^.""..^^^""..  .^...."^".^^"""....^^   ."....     
           ....        .""""...    ..             "^"".^"""^"..   "^"."^^^^^^^""......  ."""""".    
           .....      """."....    .               "^^^"   "".    "^"."."...^"............""""..    
             ..."""  ".."""""..                    "^..           .^^"".".."""............."""".    
              ."""".  .""".......                  ""   ". ..     .^..."...........""......"""".    
               ""."     """""...                         ..."      . ""......" "...  .... ...""     
                            ...                                                            ""       
                            ."""                                                                    
                      ^^^   ."...                           ..                                      
         "      ""  ^^..^   ..""..        ...         ..    .."      "              .  .".. ...     
         "      .. ^""".^    .....   ".. ......   ..."."    ^.^     .".    .       ". .."^^....     
         ".         ^"."^    """..  ....^....."  ..".".      ^^    ..^"       "....^.  " "^^..""    
               "    """".^          "...^...."""""""."....    ^^^^..."^"      ^.^^^^.    "^.""      
              .^.    "."."^   .   ......^......"""."."....   ^.......""^""    ^.^...^.   "^..."     
              "^^"  ."."."^  ...""""""""^......"""........   ^......."""^"     ^.""...   ""^^...    
     "        .^.^.  .."""^   ........".^^......".^^^.....  ^......""""^^.  .^^"."..".   .^^^...    
    ..".".    "^."^........^   ..""""""".^.^"....^..^..".^  ^."""."..^^..   ^"...."""." ..^^^...    
    .""""""   .^...^.. """..^  ".^..""".^.^....^^""""^."."^^""""".""^""     ^"".....""""..^^^..     
    .""""".. "^^""....   ."."^..^.""".".^.^^....."".^.^""""""""""..^.      ....  ..."""""""^^"^.    
    "^"""...  .".".."""     ^""^..".".^.^^......."""^..^"""""""...^..      ." . ...."""""""^^"^"    
     .^""....   " . .""      ^.^.^""....^"^....".".^....^".".".".^.             ......".""""""^"    
     .^""..."       """      ^.^.^^^...""^...."""""""....^......^.               "..  ..   "^"^"    
      .^"."    ".             ^.^"""^"^^.^^...""""^^^.........".^.               """      "^.^"     
     .^.""^    """             ^.^^^.^..^...^^^^^^"".^.."""..."^"                """.     ""^"      
     .^."^     "..      .       ^"""^"^^.^"^"............""""."^"                "..       ".       
    ^^.."^      "  .  "".  .     ^^^"^""^.^"^^^^^^""..."""""""^^"          .  .......               
    "^.""^      "  .""""." .        ^"^^"^"^"......"...."""".".^^"    ".     ..."....               
     "^"."^        """""."....      ^"""^"^......."""""""....  ".."    .     ... ..""""             
     .^"."^       .."".........      ^^^.^"^........".........  """          .    ..""        ""    
     ^..."^      ".""".... ..... .   ^  ^.^.......   """.."."."   ""       "".     "...       ".    
    .....^        ."....""  ."."...  ^  ^"".          .""   ".."       ."""""..    "...             
     "..^          "....""   "." """   ^".....        .""    .".     .......""""  ......"     .     
      ..             .."      "   ""    ^...".                         ."...."""   "  .             
                                                                                                    
                                                                                                    
                                                                                                    
                                                                                                    
