                                                                                                    
                                                                                                    
                                                                                                    
                                                                                                    
                 ..          ^^^^^.  .                            .         """..                   
     .      ." "....        ^...."....."                         .... ."" """"......        ....    
     .     ...""....        ^.^.......                     ..    ...    ""...""".".....   ......    
         ...."""""."       ^"^.........                         "...    """.^^^^^""""""  ......"    
         "".""""""""" .     ..^....."                            ."     "".^.."""^^^.".".... .."    
         ."""""""""""""..   ""^.....  ".                ".     ...    " " ""^""^^.."^"."""". .""    
       ."."^"""""".""""".....^....." "..                "... ...." " ..   ""^.^""""""....".  """    
       ."." ^"""...."""...""^"....."".."               "..""""..." "...  ""^"""""""."."".^.  """    
      "."    ^""...."."..^^^"......""""". .           ."""".....""""     ""^..."""^.....^^. .""     
              ^.^....^....."""".."......""."         "......""......     ..^."."."...".^."  ."""    
       ^^^^  ^"."^"...^.......""""...."""""".      "..."""".".".".".     ""^...^....."^"   """""    
      ^""^   ^^^^.^..^^....""""""......."""..      .........""".....      ..^^^.^."..^.    ..""     
     ^""^        ^"^..^^".."..."...."""""""...         "."........"        ""..."^..^.    ...""     
      ^^         ^"^"."^^."""""........."""...   ."    "...."""..."         .". ..^..^."  ...."     
      ^           ^.^..^^..""""  ^"""""""""      .""     ...""".                """...^.   .""      
     ^^        ^^^.^""^^^^""""""  ^."."""..        ""   ...."."  .""     ...    .."..."^"  ...      
    ..."" ..  ^...^"^^^^^^."""".  ^^^^^^^""        ................"    ".".   ""^^"^^"^"   ..      
    ....""".....^^"""^^^^"""...^                    .............."..   """.   """"^^^"^"    .      
     ...""".....^..".^^^^^"""..^                    ......."......"."   """.. ."""".^^^^"           
      """"""...^......^^^""."..^                     "...............   "......"""".^^^^            
      ."""".....^..."....".".^^              .         "............    ........"""..^              
     .""""  "..^ ^......."".^                ..        "...........         ".."""".^               
     ...""  ""^  ^^^^....."^                 "".       ""...   "..          ^""""""^^               
    "..."" """""     ^....^                  """.      "..                   ^""""^                 
       .."  """      .^."^                    "         .    ""               ^^""^       "         
         ""            ^^^                                   ..                 ^^        .         
                                                                                                    
         ..                                               "                                         
         .."                      ".......     .     .                 "     "" ""    "^"".....     
        ...."                     ......^^.   ..   ."..  "               ..."""""".  ..^^^....""    
        ..".".                   ........^.   ".  .....""".        ."."  ..""""""."..".^^.....""    
         "."". .     .               .^".^.    ......."."""    ^^  ."""^ ".  ..^"""....^.^....""    
      """"....""""" ...               "^^.      "."..."""..   ^.^   .."^ ..   ".^.""..        .     
    """"""""..."."" "...         .    "^.^.."  ".."..."""     ^^    "".^^^^    ^^""".      ."       
    """""""..".".""""....".     ..."""^"""...  "."......     ^.^^. .... ^^^   ...".^.               
    "".."""".""""""."".".""     ..""..... ."."       "".    ..^  "...".  ^^   ....^^.               
      "...""""  "......".""  ". ..."""..  ....        ..   ...     ...        ...^.^^^              
        ..""""   "..."""""   ....   "^^.   ."         "".  ."       "          ..^^^^^^.            
        "...""   "...""".    "...   "^.    .    ..               ." "           .^^..^^^.           
         ."""""   ....""    ."....  "^^"        ..              ..""""""         .^^..^^.           
         ....""    ..""     ""..."  "^^^.    ..                 .  """..          ^.."...           
      "."...."      .       "".      ""^^..  ...        "      ..   """     ^^    .""".."     ^^    
      "......               ""...""  "^..^. "...        ""      "  ""       ^^^   """".... ^^^^^    
      ........ " "         """...""   .^^^^.".^...          "..            .^     """"."""^..^^^    
       "."...... .      . ...""""""    ...^^...^....         ..            ^.^       ....".".^^     
        ""......."" ""  .."."."""""       .^."..^^...        ..  ..        ^..^^^^^^  ..."."        
        " ".."....""""  .."..."."""       ..."...^"""  ".    .......       ^...^""""."""..^.        
           ......."""     ".......""      ..."..^.."  ""."   "..."."""     ^..^ ^""""""".^..        
           "."."."""""     ......"""""   ..".".^..    ."""   """.""""".    .^^   ^""^"^".^..        
           ....    """".    ""...."""".   ."."^..     """.  "."..""""..    ^      ^^^^^^^     ..    
             ".     ."....  "."...""".    ."""..       ""......  ....".   ""         ^^^     ."     
                     .....   .......        .""        "".          ..     .                        
                                                                                                    
                                                                                                    
                                                                                                    
                                                                                                    
