                                                                                                    
                                                                                                    
                                                                                                    
                                                                                                    
       "".           .."""           ""^^   .."""   ..                      "...                    
      ........      .......... ..   .^^""^  ^."""" ""..                     """..   "               
     .........." ....^^^^^"... ""  .."^".^  ^."""" .....                    .".".             "     
    ..".".....".....^.....^^.. ..     .^."^^."""".  ...    ^"                ....            ""     
     "   .....""".^^..".....^.... ..""^..."""""."." ...   ^^^^"              ....  ^^               
         ....""."..."""..."""^..  ".""^.".""""".^."  "   ""^^"^"             ..... ^^               
          .."""""..."""^^"...^..      "^" ....^^""       ....^.."           ...."^ ^^    "          
     ..    ."""."...."^"^"."^"""     .^." .    "         ""........         .    .^...""""."."      
     .....".^""""."."""".^^""""      ..""      "          .........               ....""".."..      
     ."""".^............."^""         . .      "   """    """"""...                ...""".....      
      .".".^.....^......."^""                 """. """""" ... ....                 ..  ......"      
       "."."^.".^.... ..".                     .".^.."."^     ....                 ""   ""..."      
        .""""^^^""     .^^""     ...         ."."."^"..""^^    ...         ...     .    ..          
            ...."      "".^"    .^^."""...     ""..^^""."."^    ..        ...""         "".         
             "...^     ...^.   "^^"."."....    "."...^"""."^    ^..        .""""""..    .""         
                ^"..    ..^^.  ...^.".""....   ".....""""...^^^ ^."        .   """".   ..". .""     
                ^^"..    .".^.    "^"........   ""...  ."......^.""          """"^^^   "".""""".    
               ^".^."""    ...     "^^^....""       "   ""...".."""         ....^"^"""""".".^^."    
             ^^""^^."""     .     .^."......"           "........."""      ....^^^."""""".^^".""    
            ^""""".^""""         "..    .."""     "     """."........      .."^^^^^^"""""  "..."    
           ^"""""""^""..          .    .....            ".    .....""       "".^^^^^^.""    ."."    
            ."" """                    ...."            ..    ......."       "...^.^.."      ..     
                          ".    """.     ....                ....   .""      "........"     ...     
                        ....    .""""...."""...    .         ""..    ..        ".........  ".       
                       ."""     .".""""..."".."    .      ."....                ".... ..            
                        .             "..  "".            ."."                                      
                                           ""                                                       
      .   "                            .. ""                                                        
     ".   "....""".            ..     ."....       "     .                    "           ""...     
     ".""""....""". " """     ..."  ..""".."       ".   "..                   "  ..."    ."...."    
     "..."^..."""""   """".   .""    ^^""...            """...                  ..".."   .".. .     
    ."^^^^"""""""""     ".....^.^^..."^"....^            ."...                   ."""".   "         
    ..^.."^^^^^""""      ""."""^^^."""^^.....^           """                      .""""             
    ""^.^^^".^^"... "   ..^^^^..^^."...^^^."""^         "."."                      "."..            
    .....^..^."^""""^....^^.."""^^""""..^.^""""^        ..""".                      """      "".    
    "....^.^....^."^^^^^...^""..".""""".^"^^^""^        ..."....              "     " "     ."..    
    ....^^"."""""""."^^^....^""""..."""^".^^"""^          ""....          "".."           "..".     
    ""...."""^^..".  .""   ....""...   ^."..^...^          ...."."        "."..           .         
    """.."""^  ^.".    .   ...""""..   ....".^.".^^^       ."...""""      "...           .".        
     """."""^  ^""     ""   ""  .".      .....^."..^  ".      "...""... ......    .      ..         
      "".""^   ^".".             "."      ...""."^^   ."         """    ^"^..             .....     
      "".".^   ^"...              ..        ....^                 """" .^^.".^^^          ...""     
     ...."^   ^.".                .          """..                  .  "...""""^   ^      ...."     
    ".....  .....                             ...^                    ""."^^".".^ ^^    ...""""     
    ......   ...."                            ^...^                    """.^^."".^.^   ...""".."    
    ..  ..    .."""                            ^^.^                     ...^.^^"....^  ...""."."    
              "^..."                             ^.^                    ^...^.^^"^.^....".".....    
      .        .^...                             ^^                    .^^.^.^^^.^.^...."  .....    
     ...   .  .^...."                                                 ...^^^^^.^..^...."   ...."    
    ..."" ....^"^....                                              "...."^^^"."..^^^....     .""    
    ."""....^^^^..."                                              "".....^""^""..^^^..""     .""    
     .."".......  ..                                               ".". .."."....""  .."      "     
                                                                                                    
                                                                                                    
                                                                                                    
                                                                                                    
