                                                                                                    
                                                                                                    
                                                                                                    
                                                                                                    
        ..  ".."            .        """..""."."  .       "   "                                     
        ... ".."""""""^. """".       """"....".....".    "."""^.. ""                                
         .......""."".^.."""^". ..    ""..  ."."."."      ."^^"^.                                   
         "."....""""""^^^^^^"^"...            ...".        """^.                                    
    ... ."^^^."...""""...^^...^"..  ""      .."""...   .   """^.                                    
    .."""^"^^^....."....."....^""  """. ...."...."""  "^"."""^^.                                    
     .."""^^^.^. ""..........^."   """......". """"^.  .^...^.^.               ""                   
      ""^^." "..  ......   .....   """".. ."""   """^..^.  ^^.^.              ".""                  
     ^."^".         ...... .."""   ".""             .^^.   ..".^.             ....                  
     ^..^".         ."""   .."".   ."""      ""      ..     .".^"             ""...    "            
    ^.."""         ."""   .""""    ."."      ""            """".^.  ..       .""^""  .""""          
     ^^."^         ."."   ......^^ ."."   "               ......^. "^""     """^^""   ""..          
       ^^           "     "".^^^.^^      ."""     ".. .."""".....^"^.^"    ."."" "   "...^          
                          ."^   ^        .."""   .".^"""..."......^.^""    """".     "...^^         
                           ^             ."""".   ..^^"^^^.^.^.."^" .       ""...    """^^^  ^^     
            ""."""        ^..    ."     ".."."      .^""""^"^  "".        ."""".".    ""^^.^^...    
        .. ."""...        ^...  "."."  ..."".      .^."^^"^.^   "         "."""....    "^.^^....    
    ..""". "....".         ^... """..""."."..      .^."^^^.""^            .. .......     ^^^."."    
    "".".."""..""   ""     ^..  "..."""."""...     .^.^^^^."^^          ""    ....^."  "...^^"."    
    ...""".""....  .^"   ^^"^        ... .......   .^"^^."""^^                .."^^""""""..""""     
     .  ."""""...  .^^"  ^""^              ...".. "^"."^"."""^               ..""""^""........"     
        """""...^..^..""^"""""              ..".  ..""""^^".^                .. ."""^......."..     
        .""""...^^^...."".....    "               "^.."^""^"^                    ."  ....^^.  .     
        """ ...""^.... """ ...   .".              .^".^.  """..                         ^.^." ..    
         .  .."  .^..      .."    "                .^.^.   ".""..                       ....        
                 ....                              ..^.     ."..                         ...        
                                                     .                                    ^^.       
                  ..  ."                                             ...                  ".^.      
                ....  ."            ".""    .""""               ....."""""     ""          ....     
               "..""" ""           ...."  ........            " ..."""..." "..".""""          .     
          ""  "...."."".    """   "".. "  .......             .   ...""..""""....".". " .           
           "  """".""""".        .....      ....                 ...""^^"""".....".""""".           
          .""""......."..   ...   "..        ...              .......^"^^""""..^...."""".     "     
     ."  ".^""""..."."."".    ." "."..      ^..               ....."^"^^^^"^^..^^..."""""           
     .. ".^"^""""  ".""""     ."""."."...^^^..."   .            ...^^^^.^^^""^^^"......"""          
        ".^^."      ".""."    .""".".".""^^^.^^"^".....     .    ..^^^^.^^^^..^^""....""^           
        ..^""   "   "."""..   .......".     ^^^^."... "    """"  ..."^^.^^."^^""""....""^   .       
     ....^^"" "...  ".".....   ........"         ....     ."."   ...".^.."""...""" ....^            
     ".".^"^""...   .." "."     ^^^^....        ."".            ......^..""..."."  ^..."^           
    ^"."^..^^"..     .   "   ."".".^^""""""""  .""""      .      "..." ..""..."""   ^.".^           
    ^".""^^....             .....^^^^^^^".".    """              ....   ."  .."""   ^.".^           
    ^.""^  ^...            ......^^^^^^^""""^    """            .....          "    ^^^^^           
    ^..^  ^..^.       ""    ....^^^^^^"""...^.    ""           """....              ^               
     ^^  .".^.    .."""..   ....^.^"^"^""".^^".               """".....                             
     ^ . "^.^.    ".""""     ....."^^^"^...^.....              ".".".."."           """"            
         .^"^.   ""."       .."  """^"^ ^^^.......               ".""""."."        ..""""           
         "^.^.   ^""       ...    """"^   ....""".                 ".."""""""      """"""           
       ..^.^.   ^.."      "..      ""^    .......                   "" "...""".    ".""".".. .      
       .^..^.   ^".....""""..      ".^     ...""""                     """""""..    ""."....".      
        .^^..^^^"^^"."..."""""    ...^     ......         .""       .    ...""...    ."".....       
         ."^".".^      ."""..".   ...^    "".....          ""       "     .""""."    .... ...       
            ^^^^         """"..    ..^     ""...            "              .""""      ".            
                                                                                                    
                                                                                                    
                                                                                                    
                                                                                                    
