                                                                                                    
                                                                                                    
                                                                                                    
                                                                                                    
         ^   ^     """   ".         .         ".     .""                      ""."""                
        ^.^^^^   ""^^^.."^^""""     ..... ......    ...""""      ""    ...    ".""""         """    
         ^"^     "^...^^^..^^."      ...  ..."      ..."""""..  ...    ."""    ..."    ....."."     
     " ^^."^     .^......"."."        ."   ...      ...".  ......".    .."""   ..."     ...."...    
    ".^."...^  ""^...""..."".        ..    ..       ...     ..  ."."...^."     ..."      ...".".    
     ^"."....^"^^...^..."""...      ...    ".."                  "."^^^.       ..."       ..".""    
      ^."...".^""""^^^^.."."...    ."""     "^"       "."         ."^^^". ""   ....    .   """"     
       """....^^""^^..^^^".....   """""   .""^^""     ..."         .."^^^."    ....   "..  """"     
    .."""""^"""^.."^^.^........." ..""   ..^^"^^^.   "....        ^..^^.^..  ......  """            
       ""...^...^^^^"^^""".......""""    """" .^... ."....        ^..^^^.." "."...   """            
       """"""^^...."^^."."........."     ".   .....^.."."..       ^^..^^.^..""""..   ""             
        ""."."^^^.^""".".".........          ....".^.^^."."...      ^.."^^.".."...   ""    .        
     .    .""""^.^......." "."....           .."""^"^... .".".".    ^.^^."........   ""  .          
    ".."......^.^..""".^^"  """".      ".       ."^^^.."  """"".    ^.^^."  .....    """.".         
    ........"^.^^...."^     """       ."."      ..^"^".    ."""   ^^.^.^""   ....     ".."..        
     ......^^.^.^^...".^^         .".".".."      . ^"""     """  ^..^.^""    .  .     "......       
     ......^.^.^.^."."...^^      ...." """"...      "..          ..^.^".             """.....       
    ......^^^^^.^."""".^^^      ."..."  """".."    """          ".^.^"""   .."     ........".       
     ......^..^^".""""^         "...      "...."   ....       .."^^^.""""".""""   ....""...""..     
      .."...^^.^.""""^           "".     ""..""""   """       ".^^.""".".". ."." "........""""..    
        """.."."....^             .""   "".....""   ..""      ".^"".  """.    .  ..""......."...    
        ""."......"""              ...  .....  "".   "".       "".     .""      ."..........""".    
     .  ."....""...               ."""   "..   .....   .       .""""  ."".      ...."..........     
     .  ........."..               ".""  ...    ......     "...."".   .."."."  ""......."...."""    
     ............"".                """            ...."    ."....      " ...   ......  ."....".    
               .....                 "               .."                   .             ..         
                ""                                                                                  
                """"       .                                                                        
                """"      .."             ..   .                        ^   ..          """  ..     
               ."..  """""...    ...    .........                 .    ^.^ ....  ."""  .""""....    
               ."     "......  ^ ."""..".....""".              ^" .   ^"". ....  """""."""""".."    
               "       "".^..^^^^  .".....^^^^...              ^^    ^""".  ...  ."^^"..""".....    
                        ".""" ^^^   .....^    """         ""   ^^  ^^.."""      ."^"^..   ....."    
                        ".""   ^^^ ....^^          """"..........^^..."""        ..^^..     "...    
                         ."."    .  ..  "^..   ""  ".."...""".........."      .  ""^.^..     ""     
              ."         ....       ..  ".....    ...."..............."     ..""......^..   ""      
             ..."         ."            "....."   "........"..........   ..."............           
              ^^^.       """              .   ""   ....^...^^.......     """""........"."" ."       
              "."^.      """                   ". ....^ ....^^^^."."      ."........"."..   ."      
               .^.^."     ""                   ^.....^  ^...^^^.."."          ...^.""".""^  ...     
               .^."^^.  """"" ..               ^.....^ ^.."^^.^^."."          ."^^..."..^"   ..     
                "^"".^."""""""""        "       ^...^  ^."^^^^^^."""           ^^.^"".^^""   ..     
                "^.^^...."..""".        .        ^^.^  ^.""^^^..."""    ...   ..".^...^.".".        
                 ...^^..""."""""   .. .""          ^    ^"""..^^^^""..  ...  ...""^"^..^.."""       
                 ".^^^^.."         """"""     ..        ^"""..""""  .........."....^^.^.""""        
                  ...."".".       ...".""     ..       ^"""...""""  ."...."""" """...^.^..."""      
                   .""".....    ^^.".."       .."   .^^......"""".    ...."""  "..."..^^^."..""     
                  ...". ......."^^.^""         .".  "."""".  """..      ".""   """............""    
                  . "    ..."".^."^"^          ."." """...     . . "......"    ".."."........"""    
                  "      . "..^""".^.          """"..."""          """.....""   """."..........     
               " ""."    "   "^..""...         ".".... .          """........"       """... .".     
               "  ""           "...".          "." ..              ."..  ....         .""".  "      
                                                                                                    
                                                                                                    
                                                                                                    
                                                                                                    
